1111111111111111
1P0000C0000000E1
1011011011110111
100001000000C001
1011110111110101
1000C00000000001
1011011011110111
1C0001000000C001
101111011M111011
100000000M000001
1111111111111111