1111111111111111111111
1P000010000000010000E1
1011011011111011111101
1000010000000100000001
1011110111110111111101
1000C000000000C0000001
1011011011111011111101
1C0001000000C000000001
1011110110111011111001
100000000M000000000001
1011011111110111011101
1M00010000000000000001
1011110110111011111101
1000000000000000000001
1111111111111111111111
