1111111111
1P0000C001
1000110001
100C1000E1
1000000001
1111111111